####################################
#..................................#
#................#.................#
#................#.................#
#................#.................#
#................#.................#
#.........@........................#
#..................................#
#..................................#
####################################