#########################
#.......................#
#........qqqqqq.........#
#...###...........###...#
#....Q.............Q....#
#.......................#
#.......................#
#...###...........###...#
#...###...q...q...###...#
#........kk...kk........#
#.......................#
#.......................#
#.......................#
#..k##k...........k##k..#
#...##.............##...#
#..ssss...........ssss..#
#.......................#
#.......................#
#.......................#
#...........@...........#
#########################